CCCCCCCCCCWCCCCCCC
CCCCCCCCCCWTCCCCCC
CCCCCCCCCCWWWWWWWW
CCCCCCCCCCCCCCCCCC
CCCCCCCRCCCCCCCCCC
CCCCCCCCCCCCCCCCCC
CCCCCCCCCCCCCCCCCC
CCCCCCCCCCCCCCCCCC
CCCCCCCCCCCCCCCCCC
CCCCCCCCCCCCCCCCCC